11111111111111111111111111
10010000100000000000000001
1PC1000E000C00000000000001
100000000000000000C0000001
11111101111111111111111111
10000000000000000000000001
1C000000000000000000000001
100000000000000000C0000001
11111111111111111111111111
