1111111111111111111
1010101010100010101
1010110110001011101
1C0110110C011000C01
100000000E111111101
1110011100000000011
1P11111111111111011
1000000000000000001
1111111111111111111
