111111111
100100001
1PC1000E1
111111111
