111111111
100000001
101111101
10000E101
111111111