11111111111111111111111111
10010000100000000000000001
1PC1000E000000000000000001
1000000000000000X000000001
11111111111111111111111111
