11111111111111111111111111
1001000E100000000000X00001
1PC100X1100001100010X0C001
1000000000011XC0X010000001
11111111111111111111111111
