1111111111111111111
1010101010100010101
101011011X001011101
1C0110110C011000C01
10000X0000111111101
11E0011100000000011
1P11011111111111011
1000000000000000001
1111111111111111111
